{
	"tileset" : "tileset_map.png",
	"terrain" : [
		[4, 9, 9, 9, 9, 9, 9, 9, 9, 9, 9, 9, 9, 5, 9, 9, 9, 9, 9, 9, 9, 9, 9, 9, 9, 9, 6],
		[17, 28, 30, 30, 30, 30, 30, 30, 30, 30, 30, 30, 30, 17, 30, 30, 30, 30, 30, 30, 30, 30, 30, 30, 30, 28, 17],
		[17, 30, 4, 9, 9, 6, 30, 4, 9, 9, 9, 6, 30, 17, 30, 4, 9, 9, 9, 6, 30, 4, 9, 9, 6, 30, 17],
		[17, 30, 17, 19, 19, 17, 30, 17, 19, 19, 19, 17, 30, 17, 30, 17, 19, 19, 19, 17, 30, 17, 19, 19, 17, 30, 17],
		[17, 30, 24, 9, 9, 26, 30, 24, 9, 9, 9, 26, 30, 27, 30, 24, 9, 9, 9, 26, 30, 24, 9, 9, 26, 30, 17],
		[17, 30, 30, 30, 30, 30, 30, 30, 30, 30, 30, 30, 30, 30, 30, 30, 30, 30, 30, 30, 30, 30, 30, 30, 30, 30, 17],
		[17, 30, 8, 9, 9,  10, 30, 7, 30, 8, 9, 9, 9, 5, 9, 9, 9, 10, 30, 7, 30, 8, 9, 9,  10, 30, 17],
		[17, 28, 30, 30, 30, 30, 30, 17, 30, 30, 30, 30, 30, 17, 30, 30, 30, 30, 30, 17, 30, 30, 30, 30, 30, 28, 17],
		[24, 9, 9, 9, 9, 6, 30, 14, 9, 9, 9, 10, 30, 27, 30, 8, 9, 9, 9, 16, 30, 4, 9, 9, 9, 9, 26],
		[20, 20, 20, 20, 20, 17, 30, 17, 20, 20, 20, 20, 20, 20, 20, 20, 20, 20, 20, 17, 30, 17, 20, 20, 20, 20, 20],
		[20, 20, 20, 20, 20, 17, 30, 17, 20, 4, 9, 10, 20, 20, 20, 8, 9, 6, 20, 17, 30, 17, 20, 20, 20, 20, 20],
		[8, 9, 9, 9, 9, 26, 30, 27, 20, 17, 20, 20, 20, 20, 20, 20, 20, 17, 20, 27, 30, 24, 9, 9, 9, 9, 10],
		[ 30, 30, 30, 30, 30, 30, 30, 20, 20, 17, 20, 20, 20, 20, 20, 20, 20, 17, 20, 20, 30, 30, 30, 30, 30, 30, 30],
		[8, 9, 9, 9, 9, 6, 30, 7, 20, 17, 20, 20, 20, 20, 20, 20, 20, 17, 20, 7, 30, 4, 9, 9, 9, 9, 10],
		[20, 20, 20, 20, 20, 17, 30, 17, 20, 24, 9, 9, 9, 9, 9, 9, 9, 26, 20, 17, 30, 17, 20, 20, 20, 20, 20],
		[20, 20, 20, 20, 20, 17, 30, 17, 20, 20, 20, 20, 20, 20, 20, 20, 20, 20, 20, 17, 30, 17, 20, 20, 20, 20, 20],
		[4, 9, 9, 9, 9, 26, 30, 27, 20, 8, 9, 9, 9, 5, 9, 9, 9, 10, 20, 27, 30, 24, 9, 9, 9, 9, 6],
		[17, 28, 30, 30, 30, 30, 30, 30, 30, 30, 30, 30, 30, 17, 30, 30, 30, 30, 30, 30, 30, 30, 30, 30, 30, 28, 17],
		[17, 30, 8, 9, 9, 6, 30, 8, 9, 9, 9, 10, 30, 27, 30, 8, 9, 9, 9, 10, 30, 4, 9, 9, 10, 30, 17],
		[17, 30, 30, 30, 30, 17, 30, 30, 30, 30, 30, 30, 30, 20, 30, 30, 30, 30, 30, 30, 30, 17, 30, 30, 30, 30, 17],
		[14, 9, 9, 10, 30, 27, 30, 7, 30, 8, 9, 9, 9, 5, 9, 9, 9, 10, 30, 7, 30, 27, 30, 8, 9, 9, 16],
		[17, 30, 30, 30, 30, 30, 30, 17, 30, 30, 30, 30, 30, 17, 30, 30, 30, 30, 30, 17, 30, 30, 30, 30, 30, 30, 17],
		[17, 30, 8, 9, 9, 9, 9, 25, 9, 9, 9, 10, 30, 27, 30, 8, 9, 9, 9, 25, 9, 9, 9, 9, 10, 30, 17],
		[17, 28, 30, 30, 30, 30, 30, 30, 30, 30, 30, 30, 30, 30, 30, 30, 30, 30, 30, 30, 30, 30, 30, 30, 30, 28, 17],
		[24, 9, 9, 9, 9, 9, 9, 9, 9, 9, 9, 9, 9, 9, 9, 9, 9, 9, 9, 9, 9, 9, 9, 9, 9, 9, 26]
]

}

