{
	"tileset" : "tileset_map.png",
	"terrain" : [

		[4, 9, 9, 9, 9, 9, 9, 9, 9, 9, 9, 9, 9, 5, 9, 9, 9, 9, 9, 9, 9, 9, 9, 9, 9, 9, 6],
		[17, 19, 19, 19, 19, 19, 19, 19, 19, 19, 19, 19, 19, 17, 19, 19, 19, 19, 19, 19, 19, 19, 19, 19, 19, 19, 17],
		[17, 19, 4, 9, 9, 6, 19, 4, 9, 9, 9, 6, 19, 17, 19, 4, 9, 9, 9, 6, 19, 4, 9, 9, 6, 19, 17],
		[17, 19, 17, 19, 19, 17, 19, 17, 19, 19, 19, 17, 19, 17, 19, 17, 19, 19, 19, 17, 19, 17, 19, 19, 17, 19, 17],
		[17, 19, 24, 9, 9, 26, 19, 24, 9, 9, 9, 26, 19, 27, 19, 24, 9, 9, 9, 26, 19, 24, 9, 9, 26, 19, 17],
		[17, 19, 19, 19, 19, 19, 19, 19, 19, 19, 19, 19, 19, 19, 19, 19, 19, 19, 19, 19, 19, 19, 19, 19, 19, 19, 17],
		[17, 19, 8, 9, 9,  10, 19, 7, 19, 8, 9, 9, 9, 5, 9, 9, 9, 10, 19, 7, 19, 8, 9, 9,  10, 19, 17],
		[17, 19, 19, 19, 19, 19, 19, 17, 19, 19, 19, 19, 19, 17, 19, 19, 19, 19, 19, 17, 19, 19, 19, 19, 19, 19, 17],
		[24, 9, 9, 9, 9, 6, 19, 14, 9, 9, 9, 10, 19, 27, 19, 8, 9, 9, 9, 16, 19, 4, 9, 9, 9, 9, 26],
		[20, 20, 20, 20, 20, 17, 19, 17,19, 19, 19, 19, 19, 19, 19, 19, 19, 19, 19, 17, 19, 17, 20, 20, 20, 20, 20],
		[20, 20, 20, 20, 20, 17, 19, 17,19, 4, 9, 10, 20, 20, 20, 8, 9, 6, 19, 17, 19, 17, 20, 20, 20, 20, 20],
		[8, 9, 9, 9, 9, 26, 19, 27,19, 17, 20, 20, 20, 20, 20, 20, 20, 17, 19, 27, 19, 24, 9, 9, 9, 9, 10],
		[ 19, 19, 19, 19, 19, 19, 19, 19,19, 17, 20, 20, 20, 20, 20, 20, 20, 17, 19, 19, 19, 19, 19, 19, 19, 19, 19],
		[8, 9, 9, 9, 9, 6, 19, 7,19, 17, 20, 20, 20, 20, 20, 20, 20, 17, 19, 7, 19, 4, 9, 9, 9, 9, 10],
		[20, 20, 20, 20, 20, 17, 19, 17,19, 24, 9, 9, 9, 9, 9, 9, 9, 26, 19, 17, 19, 17, 20, 20, 20, 20, 20],
		[20, 20, 20, 20, 20, 17, 19, 17,19, 19, 19, 19, 19, 19, 19, 19, 19, 19, 19, 17, 19, 17, 20, 20, 20, 20, 20],
		[4, 9, 9, 9, 9, 26, 19, 27, 19, 8, 9, 9, 9, 5, 9, 9, 9, 10, 19, 27, 19, 24, 9, 9, 9, 9, 6],
		[17, 19, 19, 19, 19, 19, 19, 19, 19, 19, 19, 19, 19, 17, 19, 19, 19, 19, 19, 19, 19, 19, 19, 19, 19, 19, 17],
		[17, 19, 8, 9, 9, 6, 19, 8, 9, 9, 9, 10, 19, 27, 19, 8, 9, 9, 9, 10, 19, 4, 9, 9, 10, 19, 17],
		[17, 19, 19, 19, 19, 17, 19, 19, 19, 19, 19, 19, 19, 19, 19, 19, 19, 19, 19, 19, 19, 17, 19, 19, 19, 19, 17],
		[14, 9, 9, 10, 19, 27, 19, 7, 19, 8, 9, 9, 9, 5, 9, 9, 9, 10, 19, 7, 19, 27, 19, 8, 9, 9, 16],
		[17, 19, 19, 19, 19, 19, 19, 17, 19, 19, 19, 19, 19, 17, 19, 19, 19, 19, 19, 17, 19, 19, 19, 19, 19, 19, 17],
		[17, 19, 8, 9, 9, 9, 9, 25, 9, 9, 9, 10, 19, 27, 19, 8, 9, 9, 9, 25, 9, 9, 9, 9, 10, 19, 17],
		[17, 19, 19, 19, 19, 19, 19, 19, 19, 19, 19, 19, 19, 19, 19, 19, 19, 19, 19, 19, 19, 19, 19, 19, 19, 19, 17],
		[24, 9, 9, 9, 9, 9, 9, 9, 9, 9, 9, 9, 9, 9, 9, 9, 9, 9, 9, 9, 9, 9, 9, 9, 9, 9, 26]

	]
}